6 5 1 2 0 0 4 0 0
9 0 0 0 0 0 0 0 0
0 4 0 0 0 6 0 7 0
0 0 0 0 9 7 0 6 4
0 0 0 8 1 0 0 0 7
0 0 0 0 0 3 8 5 0
0 0 6 0 5 0 0 0 2
4 0 0 0 0 0 0 0 0
2 9 3 7 0 0 6 0 0
